1 1 1 1 1 1 1 1 1 1 1 1 1 1 1 1 1 1 1 1 1 1 1 1 1 1 1 1 1 1 1 1 1 1 1 1 1 1 1 1 1 1 1 1 1 1 1 1 1 1
1 5 5 5 5 5 5 5 5 5 5 5 5 5 5 5 5 5 5 5 5 5 5 5 5 5 5 5 5 10 10 10 5 5 5 5 5 5 5 5 5 5 5 5 5 5 5 5 5 1
1 5 5 5 5 4 5 5 8 5 5 5 5 5 5 5 5 5 5 5 5 5 5 8 5 5 4 5 5 10 10 10 5 5 5 5 5 5 8 5 5 5 5 5 5 5 5 4 5 1
1 5 5 5 5 5 5 5 5 5 5 5 5 5 5 5 5 5 5 5 5 5 5 5 5 5 5 5 5 5 10 10 10 5 5 5 5 5 5 5 5 5 5 5 5 5 5 5 5 1
1 5 5 5 5 5 5 5 5 5 5 5 5 5 5 5 5 5 5 5 5 5 5 5 5 5 5 5 5 5 10 10 10 5 5 5 5 5 5 5 5 5 5 5 5 5 5 5 5 1
1 5 5 5 5 5 5 5 5 5 5 5 5 5 5 5 5 5 5 5 5 5 5 5 5 5 5 5 5 3 10 10 10 3 5 9 9 5 10 10 5 10 10 5 5 5 5 5 5 1
1 5 5 5 5 5 5 5 4 5 5 5 5 5 8 5 5 5 5 5 5 5 5 5 5 5 5 5 5 10 10 10 5 5 5 9 9 9 10 5 10 10 5 5 8 5 5 5 5 1
1 5 5 5 5 5 5 5 5 5 5 5 5 5 5 5 5 5 5 5 5 5 5 5 5 5 5 5 5 10 10 10 5 5 5 9 9 9 5 10 10 5 10 5 5 5 5 5 5 1
1 5 5 5 5 5 5 5 5 5 5 5 5 5 5 5 5 5 5 5 5 5 5 5 5 5 5 5 5 10 10 10 5 5 5 9 9 9 10 10 5 10 10 5 5 5 5 5 5 1
1 5 5 5 5 5 5 5 5 5 5 5 5 5 5 5 5 5 5 5 5 5 5 5 5 5 5 5 10 10 10 5 5 5 5 9 9 9 10 10 10 10 10 5 5 5 5 5 5 1
1 5 5 5 5 8 5 5 5 5 5 4 5 5 5 5 5 5 5 5 8 5 5 5 5 5 5 3 10 10 10 3 4 5 5 9 9 9 10 10 10 10 10 5 5 5 5 5 5 1
1 5 5 5 5 5 5 5 5 5 5 5 5 5 5 5 5 5 5 5 6 5 5 5 5 5 5 5 10 10 10 5 5 5 5 9 9 9 10 10 10 10 10 5 5 5 5 5 5 1
1 5 5 5 5 5 5 5 5 5 5 5 5 5 5 5 5 5 5 5 6 5 5 5 5 5 5 5 5 10 10 10 5 5 5 9 9 9 10 10 10 10 10 5 5 5 5 5 5 1
1 5 5 5 5 5 5 5 5 5 5 5 5 5 5 5 5 5 5 5 6 5 5 5 5 5 5 5 5 10 10 10 5 5 5 9 9 9 10 10 10 10 10 5 5 5 5 5 5 1
1 5 5 5 5 5 5 5 5 5 5 8 5 5 4 11 5 5 5 5 6 5 5 5 5 5 8 5 5 10 10 10 5 5 5 9 9 9 10 10 10 10 10 5 5 5 5 5 5 1
1 5 5 5 5 5 5 5 5 5 5 5 5 5 5 12 12 19 5 5 6 5 5 5 5 11 5 3 10 10 10 3 5 5 5 9 9 9 10 10 10 10 10 5 5 5 5 5 5 1
1 5 5 5 5 5 5 5 5 5 5 5 5 5 5 12 12 5 5 5 6 5 5 5 5 7 6 6 6 6 6 6 6 6 6 9 9 9 5 10 10 10 10 5 5 5 5 5 5 1
1 5 5 5 5 5 5 5 5 5 5 5 5 5 5 6 5 5 5 5 6 5 5 6 6 6 5 5 10 10 10 5 5 5 11 9 9 9 10 10 5 10 10 11 5 5 5 5 5 1
1 5 8 5 5 5 5 5 5 5 5 5 5 5 5 6 6 8 5 5 6 6 6 5 5 5 5 10 10 10 5 5 8 5 5 15 15 15 6 6 15 15 15 5 5 5 5 8 5 1
1 5 5 5 5 5 5 5 5 5 5 5 5 5 5 5 5 6 6 6 6 5 5 5 5 5 5 11 10 10 5 5 5 5 5 15 6 6 6 6 6 6 15 5 5 5 5 5 5 1
1 5 5 5 5 5 5 5 5 5 5 6 6 6 6 6 6 6 6 6 6 6 6 6 6 6 6 7 7 6 6 6 6 5 5 15 6 15 6 6 15 6 15 5 5 5 5 5 5 1
1 5 5 5 5 5 5 5 5 5 5 5 5 6 5 5 5 5 5 5 6 13 13 13 13 5 5 7 7 10 10 5 5 5 5 15 6 6 15 15 6 6 15 5 5 5 5 5 5 1
1 5 5 5 5 5 5 5 8 5 5 5 5 6 5 5 5 5 5 5 6 13 14 14 13 18 5 5 10 10 10 5 5 5 5 15 6 6 15 15 6 6 15 5 5 5 5 5 5 1
1 5 5 5 5 5 5 5 5 5 5 5 5 5 6 5 5 5 5 5 6 13 14 14 13 5 5 5 10 10 10 5 5 5 5 15 6 15 6 6 15 6 15 5 5 5 5 5 5 1
1 5 5 5 5 5 5 5 5 5 5 5 5 5 6 5 5 5 11 5 5 13 13 13 13 5 5 5 5 10 10 10 5 5 5 15 6 6 6 6 6 6 15 5 5 5 5 5 5 1
1 5 5 5 5 5 5 5 5 5 5 5 5 5 5 6 5 5 7 5 5 5 5 5 5 5 5 5 11 10 10 10 3 5 5 15 15 15 15 15 15 15 15 5 5 5 5 5 5 1
1 5 4 5 5 5 5 5 5 5 5 5 5 5 8 6 5 5 5 5 5 5 5 4 5 5 5 5 7 10 10 10 5 5 11 9 9 9 10 10 10 10 10 11 8 5 5 5 5 1
1 5 5 5 5 5 5 5 5 5 5 5 5 5 5 6 5 5 5 5 6 5 5 5 5 5 5 5 10 10 10 5 5 5 5 9 9 9 10 10 10 10 10 5 5 5 5 5 5 1
1 5 5 5 5 5 5 5 5 5 5 5 5 5 5 6 5 5 5 5 6 5 5 5 5 5 5 5 10 10 10 5 5 5 5 9 9 9 10 10 10 10 10 5 5 5 5 5 5 1
1 5 5 5 5 5 5 5 5 5 5 5 5 5 5 6 5 5 5 5 5 5 5 5 5 5 5 5 10 10 10 5 5 5 5 9 9 9 10 10 10 10 10 5 5 5 5 5 5 1
1 5 5 5 5 8 5 5 5 5 5 5 5 5 5 6 5 5 5 5 8 5 5 5 5 5 4 5 3 10 10 10 3 5 5 9 9 9 10 10 10 10 10 5 5 5 5 4 5 1
1 5 5 5 5 5 5 5 5 5 5 5 5 5 5 6 5 5 5 5 5 5 5 5 5 5 5 5 5 10 10 10 5 5 5 5 9 9 5 10 10 10 10 5 5 5 5 5 5 1
1 5 5 5 5 5 5 5 5 5 5 5 5 5 5 5 5 5 5 5 5 5 5 5 5 5 5 5 5 10 10 5 5 5 5 9 9 5 10 10 10 10 10 5 5 5 5 5 5 1
1 5 5 5 5 5 5 5 5 5 5 5 5 5 5 5 5 5 5 5 5 5 5 5 5 5 5 5 5 5 10 10 10 5 5 9 5 9 10 5 10 10 10 5 5 5 5 5 5 1
1 5 5 5 5 5 5 5 4 5 5 8 5 5 5 8 16 8 16 8 16 5 5 5 5 5 8 5 5 4 10 10 5 5 5 5 9 9 5 10 10 10 10 5 5 5 5 5 5 1
1 5 5 5 5 5 5 5 5 5 5 5 5 5 5 16 8 16 16 8 16 5 5 5 5 5 5 5 5 3 10 5 10 3 5 9 9 5 10 10 5 10 10 5 5 5 5 5 5 1
1 5 5 5 5 5 5 5 5 5 5 5 5 5 5 16 16 17 5 16 10 5 5 5 5 5 5 5 5 10 10 10 5 5 5 9 5 9 10 5 10 10 10 5 5 5 5 5 5 1
1 5 5 5 5 5 5 5 5 5 5 5 5 5 5 8 16 5 8 10 10 5 5 5 5 5 5 5 5 10 10 10 5 5 5 5 9 9 5 10 10 10 10 5 5 5 5 5 5 1
1 5 8 5 5 5 5 5 5 5 5 4 5 5 5 16 8 16 16 16 8 5 5 5 5 5 5 5 5 10 10 5 8 5 5 9 9 5 10 10 10 10 10 5 5 5 5 8 5 1
1 5 5 5 5 5 5 5 5 5 5 5 5 5 5 16 16 16 16 16 16 5 5 5 5 5 5 5 10 10 10 5 5 5 5 9 5 9 10 10 10 10 10 5 5 5 5 5 5 1
1 5 5 5 5 5 5 5 5 5 5 5 5 5 5 5 5 5 5 5 5 5 5 5 5 5 5 3 10 10 10 3 5 5 5 5 9 9 10 10 10 10 10 5 5 5 5 5 5 1
1 5 5 5 5 5 5 5 5 5 5 5 5 5 5 5 5 5 5 5 5 5 5 5 5 5 5 5 10 10 10 5 5 5 5 9 9 9 10 10 10 10 10 5 5 5 5 5 5 1
1 5 5 5 5 5 5 5 8 5 5 5 5 5 4 5 5 5 5 5 5 5 5 8 5 5 5 5 5 10 10 10 5 5 5 9 9 9 10 10 10 10 10 5 5 5 5 5 5 1
1 5 5 5 5 5 5 5 5 5 5 5 5 5 5 5 5 5 5 5 5 5 5 5 5 5 5 5 5 10 10 10 5 5 5 9 9 9 10 10 10 10 10 5 5 5 5 5 5 1
1 5 5 5 5 5 5 5 5 5 5 5 5 5 5 5 5 5 5 5 5 5 5 5 5 5 5 5 5 10 10 10 5 5 5 9 9 9 10 10 10 10 10 5 5 5 5 5 5 1
1 5 5 5 5 5 5 5 5 5 5 5 5 5 5 5 5 5 5 5 5 5 5 5 5 5 5 3 10 10 10 3 5 5 5 5 5 5 5 5 5 5 5 5 5 5 5 5 5 1
1 5 5 5 5 5 5 5 5 5 5 5 5 5 8 5 5 4 5 5 5 5 5 5 5 5 5 5 10 10 10 5 5 5 5 5 5 5 4 5 5 5 5 5 8 5 5 5 5 1
1 5 5 5 5 5 5 5 5 5 5 5 5 5 5 5 5 5 5 5 5 5 5 5 5 5 5 5 10 10 10 5 5 5 5 5 5 5 5 5 5 5 5 5 5 5 5 5 5 1
1 5 5 5 5 5 5 5 5 5 5 5 5 5 5 5 5 5 5 5 5 5 5 5 5 5 5 10 10 10 5 5 5 5 5 5 5 5 5 5 5 5 5 5 5 5 5 5 5 1
1 1 1 1 1 1 1 1 1 1 1 1 1 1 1 1 1 1 1 1 1 1 1 1 1 1 1 1 1 1 1 1 1 1 1 1 1 1 1 1 1 1 1 1 1 1 1 1 1 1
